=============================================================================
=S                                                                          =
=== ===== === ========= ==== =========== ======= ================= ==========
=== =====         ==   == == ==========          = = = = = = = = =   =      =
===    ========== == ==== == = =========== === ===   =   =   =         =    =
======          = ==  =  === ===   ====          = =   =   =   =  ===========
=      = ======== ===   ===      = ====  ========= =============            =
======== =====    ====      = ==== ==========================================
======== =====    ================ ====                                     =
======   =====         ====   ===  ====                                     =
====== ==================== ==    =====                                     =
===       ================= ===========                                     =
=== == ==         ======     ==========                                     =
=== == == ======= ====   ===      =====                                     =
=   == == ======= ==== ==========                                           =
=== == == ======= ==== ===============                                      =
=== ====  ====    ==    ========== ===                                      =
===    ============== ============ ===                                      =
=== == ============== == ========= ===                                      =
===      ============    =========                                          =
======================== ========= ===                  F                   =
======================== ========= ===                                      =
========                                                                    =
=============================================================================
