00000000
0  0  F0
00 0 000
0      0
00000 00
0   0  0
0S0    0
00000000
