========================================
=S                                     =
=== ===== === ========= ==== ===========
=== =====         ==   == == ===========
===    ========== == ==== == = =========
======          = ==  =  === ===   =====
=      = ======== ===   ===      = =====
======== =====    ====      = ==== =====
======== =====    ================ =====
======   =====         ====   ===  =====
====== ==================== ==    ======
===       ================= ============
=== == ==         ======     ===========
=== == == ======= ====   ===      ======
=   == == ======= ==== ==========      =
=== == == ======= ==== =============== =
=== ====  ====    F=    ========== === =
===    ============== ============ === =
=== == ============== == ========= === =
===      ============    =========     =
======================== ========= === =
======================== ========= === =
========                               =
========================================
